1111111111111
101101P101111
101111C111111
101101E101111
1011110111111
1011110111111
1000000100011
1011110111111
1111100111111
1101110111111
1111010111111
1111111111111