1111111111111
1C1101P101111
1C11110111111
1011010101111
101111C111111
1011110111111
1CC0000100011
1011110111111
1111100111111
1101110111111
111101E111111
1111111111111