1111111111
1E000000C1
1000000001
1C000000P1
1111111111