1111111111111
1P10C010C01E1
1010101010101
1010101010101
1C001000100C1
1111111111111