11111111111111
1P000000000011
11101111111C11
10000000000011
1C111011111111
10000000000011
10000C00000011
10000000000011
11111011111C11
1C000000000011
1E00000C000011
11111111111111