1111111111111
1000000000001
1000000000001
1000000000001
1000000000001
1000000000001
1000E00000001
1000000000P01
100000C000001
1111111111111