1111111111111
1P00000000001
11101111111C1
1000000000001
1C11101111111
1000000000001
1111101111101
1C00000000001
1E0000000C001
1111111111111