1111111111111
1PCE000000001
1110111111101
1000000000001
1011101111111
1000000000001
1111101111101
1000000000001
1000000000001
1111111111111