1111111111111
1P00000000001
11111111111C1
1000000000001
1C11111111111
1000000000001
1111111111101
1C00000000001
1E00000000001
1111111111111